WWWWWWWWWWWWWWWWWW.WWWWWWW
WWWWWWWW.WWWWWWWW...WWWWWW
WWWWW...WWWWWWWWWW.B..WWWW
WWWWWWW.WWWWWWWWW...WWWWWW
WWWWWWW.....WWWWWWWW..WWWW
WWW.......WWWWWWWWWWWWWWWW
WWWW...A..WWWWWWWWWWW..WWW
WWWWW.....WWWWWWWW...WWWWW
WWWWWWW..WWWWWWWWW.C.WWWWW
WWWW..WWWWWWWWWWWW...WWWWW
WW....WWWWWWWWWWWWWWWWWWWW
WWW.WWWWWWWWWWWWWWWWWWWWWW
