WWWWWWWWWWWWWWW.WWWWWWW
WWWWW.WWWWWWWW...WWWWWW
WWWWWWWWWWWWWWW.B..WWWW
WWWW.WW.WWWWWW...WWWWWW
WWWW...WWWWWWWWWW..WWWW
W......WWWWWWWWWWWWWWWW
W...A..WWWWWWWWWWW..WWW
WW.....WWWWWWWW...WWWWW
WWWWWWWWWWWWWWWWWWWWWWW
